E  tex/ext/tree-dark.png
W  tex/ext/tree-old.png                   
S  tex/ext/tree-bark.png
N  tex/ext/tree-branch.png





C 223,     110,  80






F 60 60 80



111111111111
1 00010000W1
100001000001
100000000001
100000000001
100111110111
100000000001
111000100001
100000100001          111      11111
100100111001         10001   110000011
100100000001        1000001 10000000001
100100000001         10001 1000000000001
10111111111111111111111011100000000000001
10000000000000000000000000000000000000001
10111111111111111111111011100000000000001
100000000001         10001 1000000000001
100001111111        1000001 10000000001
111111               10001   110000011
                      111      11111
