W  tex/ext/d_tex.png
N  tex/ext/a_tex.png 
E  tex/ext/b_tex.png
S  tex/ext/c_tex.png

C 210,115,10
F 55,55,55

     111111111111
     100011000001
     100010000001
     100000000001
11111111100001111111
10000000000000000001
10000010000000000001
11111110000000000001
10000000000111111001
100010000001    1001
100010000001    10W1
111111111111    1111
