E tex/ext/e_side.png
W tex/ext/w_side.png
S tex/ext/s_side.png
N tex/ext/n_side.png

C 219,115,222
C 53,107,194

11111111111111111111111111111111111111111
1000000000000000000000000000000000W1
111111111111111111111111111111111111
