G  "tex/w_side.png"
N  "tex/n_side.png" 
E  "tex/e_side.png"
S  "tex/s_side.png"

111111111111
100001000001
100X01000001
100000000001
100111110111
100000100001
111000100001
100000000001
100111110001
100100000001
1001 1000001
1111 1111111