111111111111
100001000001
100001000001
100000000001
100111110111
100000000001
111000100001
100000100001
10-100111001
10X100000001
10-100000001
111111111111
