E  tex/e_side.png
W  tex/w_side.png
S  tex/s_side.png
N  tex/n_side.png 

C 210,115,0

F 53,107,194

111111111111
100001000001
100S01000001
100000000001
100111110111
100000000001
111000100001
100000100001
100100111001
100100000001
100100000001
111111111111
