     111111111111
     100011000001
     100010000001
     100000111111
111111000001
100000000001
111000100001
100000100001
100100111001
100100000001
1N0100000001
111111111111
