E  "tex/e_side.png"

W  "tex/w_side.png"

S  "tex/s_side.png"
N  "tex/n_side.png"

C 210,115,0

F 155,155,10


     111111111111
     100011000001
     100010000001
     100000111111
111111000001
10000000E001
111000100001
100000100001
100100111001
100100000001
100100000001
111111111111
