W  tex/w_side.png
N  tex/n_side.png 
E  tex/e_side.png
S  tex/s_side.png

C 210,115,0
F 53,107,194

     111111111111
     100011000001
     100010000001
     100000000001
11111111100001111111
10000000000000000001
10000010000000000001
11111110000000000001
10000000000111111001
100010000001    1001
100010000001    10W1
111111111111    1111
