
W  tex/ext/hay-straw.png
N  tex/ext/ivy-caper-leaves.png
S  tex/ext/hedge-wall.png
E  tex/ext/grass-clover.png

C 215,115,55
F 25,105,95

111111111
100000001
100000001
100000001
100010001
100000001
100000001
1000W0001
111111111
