$ 2/2
! 1/(
+ 2/<
< 2/>
> 2/<
( 1/)
) 1/(
* 1/0
# 2/0
a tex/ext/old-wood-planks.png
b tex/ext/tree-bark.png
c tex/ext/tree-branch.png
d tex/ext/tree-dark.png
e tex/ext/tree-old.png
f tex/ext/dark-metal.png
z tex/ext/skymap3.png
0 tex/ext/grass-floor.png
1 tex/ext/smooth-sand-dunes.png tex/ext/starry-night-sky_.png

A ebcd
B aaaa
C ffff

AAAAAAAAAAAAAAAAAAAAAAAAAAAAAAAAAAAAAAAAAAAAAAAAAAAAAA
A0000000000000000000000000000000000000000000000000000A
A0000000000000000000000000000000000000000000000000000A
A0000000000B0000000000B0000000000B00000000000B0000000A
A0000000000000000000000000000000000000000000000000000A
A000000000000000000000$0000000@0000000000000000000000A
A0000000000B0000000000B0000000000B00000000000B0000000A
A0000000000000000000000000000000000000000000000000000A
A00000000000000#000000000000+000000000000000000000000A
A0000000000B000000*000B0000000000B00000000000B0000000A
A0000000000000000000000000000000000<00000000000000000A
A0000000000000000000000000000000000000000000000000000A
A0000000000B000000)000B0000000000B00000000000B0000000A
A0000000000000000000000000000000000000000000000000000A
A0000000000000000000000000000000000000000000000000000A
A0000000000B0000000000B0000000000B00000000000B0000000A
A0000000000000000000000000000000000000000000000000000A
A0000000000B0000000000B0000000000B00000000000B0000000A
A0000000000000000000000000000000000000000000000000000A
AAAAAAAAAAAAAAAAAAAAAAAAAAAAAAAAAAAAAAAAAAAAAAAAAAAAAA
A1111111111C111111111111111C1111111111111111111111111A
A1111C111111111111111111C11111111111111111C1111111111A
A1111111111111111>1111111111111111C11111(111111111111A
A111111C11111111111111111111111111111111111111C111111A
A111111111111111C111111111!1111111C1111111111C1111111A
AAAAAAAAAAAAAAAAAAAAAAAAAAAAAAAAAAAAAAAAAAAAAAAAAAAAAA