S  tex/ext/wall_concret.png
W  tex/ext/pink-flowers.png
E  tex/ext/purple-flowers.png
N  tex/ext/travertine-stone.png

C 250,250,10
F 130,180,180
11111111111111111111111111111111111111111
1000000000000000000000000W00000001
111111111111111111111111111111111111
