! 1/#
+ 2/%
# 1/%
% 1/#
$ 2/&
& 2/$
a tex/ext/rusty-metal.png
b tex/ext/dark-metal.png
c tex/ext/white-marble.png
d tex/ext/travertine-stone.png
z tex/ext/skymap3.png
0 tex/ext/floortile4.png tex/ext/starry-night-sky_.png

A abcd

AAAAAAAAAAAAAAAAAAAAAAAAAAAAAAAAAAAAAAAAAAAAAAAAAAAAAA
A0000000000000000000000000000000000000000000000000000A
A0000000000000000000000000000000000000000000000000000A
A0000000000B0000000000B0000000000B00000000000B0000000A
A0000000000000000000000000000000000000000000000000000A
A00000000000000000000000000000@0000000000000000000000A
A0000000000B0000000000B0000000000B00000000000B0000000A
A0000000000000000000000000000000000000000000000000000A
A0000000000000000000000000000000000000000000000000000A
A0000000000B0000000000B0000000000B00000000000B0000000A
A0000000000000000000000000000000000000000000000000000A
A0000000000000000000000000000000000000000000000000000A
A0000000000B0000000000B0000000000B00000000000B0000000A
A0000000000000000000000000000000000000000000000000000A
A0000000000000000000000000000000000000000000000000000A
A0000000000B0000000000B0000000000B00000000000B0000000A
A0000000000000000000000000000000000000000000000000000A
A0000000000000000000000000000000000000000000000000000A
A0000000000B0000000000B0000000000B00000000000B0000000A
A0000000000000000000000000000000000000000000000000000A
A0000000000000000000000000000000000000000000000000000A
A0000000000B0000000000B0000000000B00000000000B0000000A
A0000000000000000000000000000000000000000000000000000A
A0000000000000000000000000000000000000000000000000000A
A0000000000B0000000000B0000000000B00000000000B0000000A
A0000000000000000000000000000000000000000000000000000A
A0000000000000000000000000000000000000000000000000000A
A0000000000B0000000000B0000000000B00000000000B0000000A
AAAAAAAAAAAAAAAAAAAAAAAAAAAAAAAAAAAAAAAAAAAAAAAAAAAAAA