a tex/ext/ivy-caper-leaves.png
b tex/ext/hay-straw.png
c tex/ext/grass-clover.png
d tex/ext/hedge-wall_a.png
e tex/ext/hedge-wall.png
f tex/ext/purple-flowers.png
g tex/ext/pink-flowers.png
z tex/ext/skymap3.png
0 tex/ext/floortile4.png

A eaec
B bbbb

AAAAAAAAAAAAAAAAAAAAAAAAAAAAAAAAAAAAAAAAAAAAAAAAAAAAAAAAAAAAAAAAAAAAAAAAAAAAAAAAAAAAAAAAAAAAAAAAAAAAAAAAAAAAAAAAAAAAAAAAAAAAAAAAAAAAAAAAAAAAAAAAAAAAAAAAAAAAAAAAAAAAAAAAAAAAAAAAAAAAAAAAAAAAAAAAAAAAAAAAAAAAAAAAAAAAAAAAAAAAAAAAAAAAAAAAAAAAAAAAAAAAAAAAAAAAAAAAAAAAAAAAAAAAAAAAAAAAAAAAAAAAAAAAAAAAAAAAAAAAAAAAAAAAAAAAAAAAAAAA
A000000000000000000000000000000000000000000000000000000000000000000000000000000000000000000000000000000000000000000000000000000000000000000000000000000000000000000000000000000000000000000000000000000000000000000000000000000000000000000000000000000000000000000000000000000000000000000000000000000000000000000000000000000A
A000000000000000000000000000000000000000000000000000000000000000000000000000000000000000000000000000000000000000000000000000000000000000000000000000000000000000000000000000000000000000000000000000000000000000000000000000000000000000000000000000000000000000000000000000000000000000000000000000000000000000000000000000000A
A0000000000B0000000000B0000000000B00000000000B00000000000B0000000000B0000000000B00000000000B0000000000B0000000000B0000000000B0000000000B00000000000B00000000000B0000000000B0000000000B00000000000B0000000000B0000000000B0000000000B0000000000B00000000000B00000000000B0000000000B0000000000B00000000000B0000000000B0000000000B0A
A000000000000000000000000000000000000000000000000000000000000000000000000000000000000000000000000000000000000000000000000000000000000000000000000000000000000000000000000000000000000000000000000000000000000000000000000000000000000000000000000000000000000000000000000000000000000000000000000000000000000000000000000000000A
A00000000000000000000000000000@000000000000000000000000000000000000000000000000000000000000000000000000000000000000000000000000000000000000000000000000000000000000000000000000000000000000000000000000000000000000000000000000000000000000000000000000000000000000000000000000000000000000000000000000000000000000000000000000A
A0000000000B0000000000B0000000000B00000000000B00000000000B0000000000B0000000000B00000000000B0000000000B0000000000B0000000000B0000000000B00000000000B00000000000B0000000000B0000000000B00000000000B0000000000B0000000000B0000000000B0000000000B00000000000B00000000000B0000000000B0000000000B00000000000B0000000000B0000000000B0A
A000000000000000000000000000000000000000000000000000000000000000000000000000000000000000000000000000000000000000000000000000000000000000000000000000000000000000000000000000000000000000000000000000000000000000000000000000000000000000000000000000000000000000000000000000000000000000000000000000000000000000000000000000000A
A000000000000000000000000000000000000000000000000000000000000000000000000000000000000000000000000000000000000000000000000000000000000000000000000000000000000000000000000000000000000000000000000000000000000000000000000000000000000000000000000000000000000000000000000000000000000000000000000000000000000000000000000000000A
A0000000000B0000000000B0000000000B00000000000B00000000000B0000000000B0000000000B00000000000B0000000000B0000000000B0000000000B0000000000B00000000000B00000000000B0000000000B0000000000B00000000000B0000000000B0000000000B0000000000B0000000000B00000B00000B00000000000B0000000000B00000000B000000B000000B0000000000B0000000000B0A
A000000000000000000000000000000000000000000000000000000000000000000000000000000000000000000000000000000000000000000000000000000000000000000000000000000000000000000000000000000000000000000000000000000000000000000000000000000000000000000000000000000000000000000000000000000000000000000000000000000000000000000000000000000A
A000000000000000000000000000000000000000000000000000000000000000000000000000000000000000000000000000000000000000000000000000000000000000000000000000000000000000000000000000000000000000000000000000000000000000000000000000000000000000000000000000000000000000000000000000000000000000000000000000000000000000000000000000000A
A0000000000B0000000000B0000000000B00000000000B00000000000B0000000000B0000000000B00000000000B0000000000B0000000000B0000000000B0000000000B00000000000B00000000000B0000000000B0000000000B00000000000B0000000000B0000000000B0000000000B0000000000B00000000000B00000000000B0000000000B0000000000B00000000000B0000000000B0000000000B0A
A000000000000000000000000000000000000000000000000000000000000000000000000000000000000000000000000000000000000000000000000000000000000000000000000000000000000000000000000000000000000000000000000000000000000000000000000000000000000000000000000000000000000000000000000000000000000000000000000000000000000000000000000000000A
A000000000000000000000000000000000000000000000000000000000000000000000000000000000000000000000000000000000000000000000000000000000000000000000000000000000000000000000000000000000000000000000000000000000000000000000000000000000000000000000000000000000000000000000000000000000000000000000000000000000000000000000000000000A
A0000000000B0000000000B0000000000B00000000000B00000000000B0000000000B0000000000B00000000000B0000000000B0000000000B0000000000B0000000000B00000000000B00000000000B0000000000B0000000000B00000000000B0000000000B0000000000B0000000000B0000000000B00000000000B00000000000B0000000000B0000000000B00000000000B0000000000B0000000000B0A
A000000000000000000000000000000000000000000000000000000000000000000000000000000000000000000000000000000000000000000000000000000000000000000000000000000000000000000000000000000000000000000000000000000000000000000000000000000000000000000000000000000000000000000000000000000000000000000000000000000000000000000000000000000A
A000000000000000000000000000000000000000000000000000000000000000000000000000000000000000000000000000000000000000000000000000000000000000000000000000000000000000000000000000000000000000000000000000000000000000000000000000000000000000000000000000000000000000000000000000000000000000000000000000000000000000000000000000000A
A0000000000B0000000000B0000000000B00000000000B00000000000B0000000000B0000000000B00000000000B0000000000B0000000000B0000000000B0000000000B00000000000B00000000000B0000000000B0000000000B00000000000B0000000000B0000000000B0000000000B0000000000B00000000000B00000000000B0000000000B0000000000B00000000000B0000000000B0000000000B0A
A000000000000000000000000000000000000000000000000000000000000000000000000000000000000000000000000000000000000000000000000000000000000000000000000000000000000000000000000000000000000000000000000000000000000000000000000000000000000000000000000000000000000000000000000000000000000000000000000000000000000000000000000000000A
A000000000000000000000000000000000000000000000000000000000000000000000000000000000000000000000000000000000000000000000000000000000000000000000000000000000000000000000000000000000000000000000000000000000000000000000000000000000000000000000000000000000000000000000000000000000000000000000000000000000000000000000000000000A
A0000000000B0000000000B0000000000B00000000000B00000000000B0000000000B0000000000B00000000000B0000000000B0000000000B0000000000B0000000000B00000000000B00000000000B0000000000B0000000000B00000000000B0000000000B0000000000B0000000000B0000000000B00000B00000B00000000000B0000000000B00000000B000000B000000B0000000000B0000000000B0A
A000000000000000000000000000000000000000000000000000000000000000000000000000000000000000000000000000000000000000000000000000000000000000000000000000000000000000000000000000000000000000000000000000000000000000000000000000000000000000000000000000000000000000000000000000000000000000000000000000000000000000000000000000000A
A000000000000000000000000000000000000000000000000000000000000000000000000000000000000000000000000000000000000000000000000000000000000000000000000000000000000000000000000000000000000000000000000000000000000000000000000000000000000000000000000000000000000000000000000000000000000000000000000000000000000000000000000000000A
A0000000000B0000000000B0000000000B00000000000B00000000000B0000000000B0000000000B00000000000B0000000000B0000000000B0000000000B0000000000B00000000000B00000000000B0000000000B0000000000B00000000000B0000000000B0000000000B0000000000B0000000000B00000000000B00000000000B0000000000B0000000000B00000000000B0000000000B0000000000B0A
A000000000000000000000000000000000000000000000000000000000000000000000000000000000000000000000000000000000000000000000000000000000000000000000000000000000000000000000000000000000000000000000000000000000000000000000000000000000000000000000000000000000000000000000000000000000000000000000000000000000000000000000000000000A
A000000000000000000000000000000000000000000000000000000000000000000000000000000000000000000000000000000000000000000000000000000000000000000000000000000000000000000000000000000000000000000000000000000000000000000000000000000000000000000000000000000000000000000000000000000000000000000000000000000000000000000000000000000A
A0000000000B0000000000B0000000000B00000000000B00000000000B0000000000B0000000000B00000000000B0000000000B0000000000B0000000000B0000000000B00000000000B00000000000B0000000000B0000000000B00000000000B0000000000B0000000000B0000000000B0000000000B00000000000B00000000000B0000000000B0000000000B00000000000B0000000000B0000000000B0A
A000000000000000000000000000000000000000000000000000000000000000000000000000000000000000000000000000000000000000000000000000000000000000000000000000000000000000000000000000000000000000000000000000000000000000000000000000000000000000000000000000000000000000000000000000000000000000000000000000000000000000000000000000000A
A000000000000000000000000000000000000000000000000000000000000000000000000000000000000000000000000000000000000000000000000000000000000000000000000000000000000000000000000000000000000000000000000000000000000000000000000000000000000000000000000000000000000000000000000000000000000000000000000000000000000000000000000000000A
A0000000000B0000000000B0000000000B00000000000B00000000000B0000000000B0000000000B00000000000B0000000000B0000000000B0000000000B0000000000B00000000000B00000000000B0000000000B0000000000B00000000000B0000000000B0000000000B0000000000B0000000000B00000000000B00000000000B0000000000B0000000000B00000000000B0000000000B0000000000B0A
A000000000000000000000000000000000000000000000000000000000000000000000000000000000000000000000000000000000000000000000000000000000000000000000000000000000000000000000000000000000000000000000000000000000000000000000000000000000000000000000000000000000000000000000000000000000000000000000000000000000000000000000000000000A
A000000000000000000000000000000000000000000000000000000000000000000000000000000000000000000000000000000000000000000000000000000000000000000000000000000000000000000000000000000000000000000000000000000000000000000000000000000000000000000000000000000000000000000000000000000000000000000000000000000000000000000000000000000A
A0000000000B0000000000B0000000000B00000000000B00000000000B0000000000B0000000000B00000000000B0000000000B0000000000B0000000000B0000000000B00000000000B00000000000B0000000000B0000000000B00000000000B0000000000B0000000000B0000000000B0000000000B00000B00000B00000000000B0000000000B00000000B000000B000000B0000000000B0000000000B0A
A000000000000000000000000000000000000000000000000000000000000000000000000000000000000000000000000000000000000000000000000000000000000000000000000000000000000000000000000000000000000000000000000000000000000000000000000000000000000000000000000000000000000000000000000000000000000000000000000000000000000000000000000000000A
A000000000000000000000000000000000000000000000000000000000000000000000000000000000000000000000000000000000000000000000000000000000000000000000000000000000000000000000000000000000000000000000000000000000000000000000000000000000000000000000000000000000000000000000000000000000000000000000000000000000000000000000000000000A
A0000000000B0000000000B0000000000B00000000000B00000000000B0000000000B0000000000B00000000000B0000000000B0000000000B0000000000B0000000000B00000000000B00000000000B0000000000B0000000000B00000000000B0000000000B0000000000B0000000000B0000000000B00000000000B00000000000B0000000000B0000000000B00000000000B0000000000B0000000000B0A
A000000000000000000000000000000000000000000000000000000000000000000000000000000000000000000000000000000000000000000000000000000000000000000000000000000000000000000000000000000000000000000000000000000000000000000000000000000000000000000000000000000000000000000000000000000000000000000000000000000000000000000000000000000A
A0000000000B0000000000B0000000000B00000000000B00000000000B0000000000B0000000000B00000000000B0000000000B0000000000B0000000000B0000000000B00000000000B00000000000B0000000000B0000000000B00000000000B0000000000B0000000000B0000000000B0000000000B00000000000B00000000000B0000000000B0000000000B00000000000B0000000000B0000000000B0A
A000000000000000000000000000000000000000000000000000000000000000000000000000000000000000000000000000000000000000000000000000000000000000000000000000000000000000000000000000000000000000000000000000000000000000000000000000000000000000000000000000000000000000000000000000000000000000000000000000000000000000000000000000000A
A000000000000000000000000000000000000000000000000000000000000000000000000000000000000000000000000000000000000000000000000000000000000000000000000000000000000000000000000000000000000000000000000000000000000000000000000000000000000000000000000000000000000000000000000000000000000000000000000000000000000000000000000000000A
AAAAAAAAAAAAAAAAAAAAAAAAAAAAAAAAAAAAAAAAAAAAAAAAAAAAAAAAAAAAAAAAAAAAAAAAAAAAAAAAAAAAAAAAAAAAAAAAAAAAAAAAAAAAAAAAAAAAAAAAAAAAAAAAAAAAAAAAAAAAAAAAAAAAAAAAAAAAAAAAAAAAAAAAAAAAAAAAAAAAAAAAAAAAAAAAAAAAAAAAAAAAAAAAAAAAAAAAAAAAAAAAAAAAAAAAAAAAAAAAAAAAAAAAAAAAAAAAAAAAAAAAAAAAAAAAAAAAAAAAAAAAAAAAAAAAAAAAAAAAAAAAAAAAAAAAAAAAAAAA