! 1/^
+ 2/<
< 2/>
> 2/<
^ 1/_
_ 1/^
= 2/9    
a tex/ext/stone-mountain-rock.png
b tex/ext/grass-clover.png
c tex/ext/ivy-caper-leaves.png
z tex/ext/sky_star.png
0 tex/ext/smooth-sand-dunes.png tex/ext/bay_window_.png
1 tex/ext/red-sand-ground.png tex/ext/outer_sky_.png

A aaaa
B bbbb

AAAAAAAAAAAAAAAAAAAAAAAAAAAAAAAAAAAA
A0000000000000000000000000000000000A
A0000000@00000!000^0000000000000000A
A0000000000000000000000000000000000A
A0000000000000000000000000000000000A
A000000000BBBBBBBBBBBBB000000000000A
A000000000B11111111111B000000000000A
A000000000B1_11+1111<1B000000000000A
A000000000B11111111111B000000000000A
A000000000BBBBBBBBBBBBB000000000000A
A0000000000000000000000000000000000A
A00000000=00000>0000000000000000000A
A0000000000000000000000000000000000A
AAAAAAAAAAAAAAAAAAAAAAAAAAAAAAAAAAAA
