111111111
100000001
100000001
100000001
200010001
300000001
200000001
1000W0001
111111111