+ 2/<
~ 2/>
> 2/<
a tex/ext/stone-mountain-rock.png
z tex/ext/sky_star.png
0 tex/ext/smooth-sand-dunes.png tex/ext/bay_window_.png

A aaaa

AAAAAAAAAAAAAAAAAAAAAAAAAAAAAAAAAAAA
A0000000000@00000000000000000000000A
A00000000000000+0000000000000000000A
A00000000000000000<0000000000000000A
A0000000000000000000>00000000000000A
AAAAAAAAAAAAAAAAAAAAAAAAAAAAAAAAAAAA
