! 2/<
< 2/>
> 2/<
a tex/ext/travertine-stone.png
b tex/ext/dark-metal.png
c tex/ext/white-marble.png
z tex/ext/skymap3.png
0 tex/ext/grass-floor.png tex/ext/semi_blurry_glass_.png
1 tex/ext/smooth-sand-dunes.png tex/ext/starry-night-sky_.png

A aaaa
B cccc

AAAAAAAAAAAAAAAAAAAAAAAAAAAAAAAAAAAA
A0000000000000000000000000A00000000A
A0000>00@00!000<0000000000A00000000A
A0000000000000000000000000A00000000A
A0000000000000000000000000A00000000A
AAAAAAAAAAAAAAAAAAAAAAAAAAAAAA000AAA
BBBBBBBBBBBBBBBBBBBBBBBBBBBBBB111BBB
B1111111111111111111111111111111111B
B1111111111111111111111111111111111B
B1111111111111111111111111111111111B
BBBBBBBBBBBBBBBBBBBBBBBBBBBBBBBBBBBB
