E  tex/a_tex.png
W  tex/b_tex.png
S  tex/c_tex.png
N  tex/n_side.png 

C tex/sky_star.png
F tex/floor.png

111111111111
100001000001
100001000001
100000000001
100111110111
100000000001
111000100001
100000100001
100100111001
100100000001
1N0100000001
111111111111