E  tex/e_side.png
W  tex/w_side.png
S  tex/s_side.png
N  tex/n_side.png 

C 210,115,0

F 53,107,194

111111111111111111111111111111111111
1000000000000000000000000000000000W1
111111111111111111111111111111111111
