a tex/ext/rusty-metal.png
b tex/ext/dark-metal.png
c tex/ext/grunge-rock.png
d tex/ext/travertine-stone.png
e tex/ext/white-marble.png
f tex/ext/comida_pan.png
z tex/ext/sky_star.png
0 tex/ext/floor.png

A abcd
B efef
C aaaa



111                1111  1111          1111
1S11    1111111   110011110011  111111110011
10001  110000011 1100001100001111000000000011
11001  1001110011100110010010000001111110011
11000110001111001001111000011111111    1111
 1100000011  1100011  111111
  11100011    11111
    11111
