a tex/ext/rusty-metal.png
b tex/ext/dark-metal.png
c tex/ext/grunge-rock.png
d tex/ext/travertine-stone.png
e tex/ext/white-marble.png
f tex/ext/comida_pan.png
z tex/ext/sky_star.png
0 tex/ext/floor.png

A abcd
B efef
C aaaa

11111111111111111111111111111111111111111
1000000000000000000000000000000000W1
111111111111111111111111111111111111
