
W  "tex/w_side.png"
N  "tex/n_side.png"
S  "tex/s_side.png"
E  "tex/e_side.png"

C tex/sky_star.png
F tex/floor.png

111111111
100000001
100000001
100000001
100000001
100000001
100000001
1000E0001
111111111

