E  tex/e_side.png
W  tex/w_side.png
S  tex/s_side.png
N  tex/n_side.png 

C 210,115,0

F 53,107,194

111   111
101   1S11111
101   10000011
101   10111001
1011 1101 1101
10011100111001
11001000000011
 110001111111
  11111
