A aaaa

C 220,110,0
F 60,60,80

AAAAAAAAA
A0000000A
A0000000A
A0000000A
A000A000A
A0000000A
A00N0000A
A0000000A
AAAAAAAAA
