E  tex/ext/tree-dark.png
W  tex/ext/tree-old.png                   
S  tex/ext/tree-bark.png
N  tex/ext/tree-branch.png

C 220 ,110,0
F 60,60,80

111111111
100000001
100000001
100000001
100010001
100000001
100000001
100000001
100010001
100000001
100000001
10N000001
111111111
